###########################################
# Syntax I2C_RotaryEncoder library
###########################################

###########################################
# Datatypes (KEYWORD1)
###########################################

I2CRE                	KEYWORD1
INTERRUPT_BIT        	KEYWORD1
COUNTUP_BIT          	KEYWORD1
COUNTDOWN_BIT        	KEYWORD1
PRESSED_BIT          	KEYWORD1
QUICKRELEASE_BIT     	KEYWORD1
MIDRELEASE_BIT       	KEYWORD1
LONGRELEASE_BIT      	KEYWORD1
CMD_READCONF         	KEYWORD1
CMD_WRITECONF        	KEYWORD1
CMD_REBOOT           	KEYWORD1
STNG_FLIPMODE        	KEYWORD1
STNG_TURNMODE        	KEYWORD1
STNG_HWROTDIR        	KEYWORD1

###########################################
# Methods and Functions (KEYWORD2)
###########################################

getStatus            	KEYWORD2                               
getRotVal            	KEYWORD2 
getRotStep           	KEYWORD2 
getRotMin            	KEYWORD2 
getRotMax            	KEYWORD2
getRotSpinTime       	KEYWORD2
getWhoAmI            	KEYWORD2
getLedRed            	KEYWORD2                    
getLedGreen          	KEYWORD2 
getLedBlue           	KEYWORD2 
getDebounceTime      	KEYWORD2
getMidPressTime      	KEYWORD2
getLongPressTime     	KEYWORD2
getMajorRelease      	KEYWORD2
getMinorRelease      	KEYWORD2
getModeSettings      	KEYWORD2
setRotVal            	KEYWORD2                                                                
setRotStep           	KEYWORD2 
setRotMin            	KEYWORD2          
setRotMax            	KEYWORD2 
setRotSpinTime       	KEYWORD2 
setRGBcolor          	KEYWORD2
setLedRed            	KEYWORD2          
setLedGreen          	KEYWORD2
setLedBlue           	KEYWORD2 
setDebounceTime      	KEYWORD2
setMidPressTime      	KEYWORD2
setLongPressTime     	KEYWORD2
setModeSetBit        	KEYWORD2
setModeClearBit      	KEYWORD2
writeCommand         	KEYWORD2
setI2Caddress        	KEYWORD2      
isRotValChanged      	KEYWORD2
isRotValChangedUp    	KEYWORD2
isRotValChangedDown  	KEYWORD2
isButtonPressed      	KEYWORD2
isButtonQuickReleased	KEYWORD2
isButtonMidReleased  	KEYWORD2
isButtonLongReleased 	KEYWORD2
